{
    "map": [
            [0, 1, 2, 0, 1, 2, 0, 1, 2, 0, 1, 2, 0, 1, 2, 0 ],
            [1, 2, 0, 1, 4, 4, 4, 5, 6, 0, 1, 2, 0, 1, 2, 0 ],
            [0, 1, 2, 0, 1, 2, 0, 1, 2, 0, 1, 2, 0, 1, 2, 0 ],
            [6, 1, 2, 0, 1, 2, 9, 1, 2, 0, 1, 2, 0, 1, 2, 0 ],
            [7, 1, 2, 0, 1, 2, 10, 1, 2, 0, 1, 2, 0, 1, 2, 5 ],
            [0, 1, 2, 8, 1, 2, 11, 1, 2, 0, 1, 2, 0, 1, 2, 0 ],
            [0, 1, 2, 0, 1, 2, 0, 1, 2, 0, 1, 2, 0, 1, 2, 0 ],
            [0, 1, 2, 0, 1, 2, 0, 1, 2, 0, 1, 2, 0, 1, 2, 0 ],
            [0, 1, 2, 0, 1, 2, 0, 1, 2, 0, 1, 2, 0, 1, 2, 0 ],
            [0, 1, 2, 0, 1, 2, 0, 1, 2, 0, 1, 2, 0, 1, 2, 0 ],
            [0, 1, 2, 0, 1, 2, 0, 1, 2, 0, 1, 2, 0, 1, 2, 0 ],
            [0, 1, 2, 0, 1, 2, 0, 1, 2, 0, 1, 2, 0, 1, 2, 0 ]
    ],
    "name" : "Swamp",
    "width" : 1280,
    "height" : 960
}